U.S. Treasury Secretary Steven Mnuchin said on Saturday that Washington wants to include a provision to deter currency manipulation in future trade deals, including with Japan, based on the currency chapter in the new deal to revamp NAFTA.	 Steven Mnuchin 	U.S. Treasury Secretary
Norman was not on the field because he decided to tune out coach Jay Gruden at halftime, said Redskins pregame host Kevin Sheehan on his podcast on Friday.	 Kevin Sheehan	Redskins pregame host
Washington Redskins cornerback Josh Norman was burned for a long touchdown pass in Monday night's loss in New Orleans, but that wasn't the reason he was benched to start the second half, according to one report.	Josh Norman	Washington Redskins cornerback
Yana Pechenik, a physician assistant at MyBotoxLA, said the woman agreed to receive $5,000 in services.	Yana Pechenik	physician assistant at MyBotoxLA
“It’s still a search and recovery at this point,” Quogue Village Police Chief Christopher Isola said at a news conference late afternoon on Oct. 13, according to Newsday.	Christopher Isola	Quogue Village Police Chief
Quogue resident Tim Carbone told WABC.	Tim Carbone	Quogue resident
Kirby Evans, who lost his nose and one of his eyes during a battle with cancer, told WCSC he was asked  to cover up if he wanted to eat at the store and gas station called the Forks Pit Stop.	Kirby Evans	who lost his nose and one of his eyes during a battle with cancer
LYNCHBURG, Va. -- Troy redshirt sophomore kicker Tyler Sumpter had a trio of opportunities to put points on the board for the Trojans.	Tyler Sumpter	Troy redshirt sophomore kicker
Like Dr. Frankenstein, the modder was fully aware that the product was not ideal, practical, or perfect by any stretch. Shank wrote on their blog that the product dubbed “Kill Mii” was “not logical, comfortable, or practical. But it must be done… for the memes.”	Frankenstein	Dr.
Her colleagues are 78-year-old Marion Gilham and 72-year-old former civil engineer John Huggins, who last year lost a leg to diabetes.	John Huggins	former civil engineer
"They have a great work ethic. We love having them here,” assistant store manager Jay McKinney said of his older employees.	Jay McKinney	assistant store manager
Minnesota Vikings running back Dalvin Cook is expected to play Sunday against the Arizona Cardinals, though for only about half of the offensive snaps, if that, a source told ESPN's Adam Schefter.	Dalvin Cook	Minnesota Vikings running back
We're not seeing pay raises go up and the inflation is really eating up whatever pay raises people are getting," said Ilyce Glink, CEO of Best Money Moves.	Ilyce Glink	CEO of Best Money Moves
 We've just about duplicated the amount of money that we've had brought in through the surtax," Bay County Commissioner Philip Griffitts said.	Philip Griffitts 	Bay County Commissioner
WASHINGTON (Reuters) - President Donald Trump said on Saturday the release of U.S. pastor Andrew Brunson after two years in Turkish custody was a "tremendous step" toward improved relations with Turkey, but he denied cutting a deal with Ankara.	Donald Trump	President
Trump also thanked President Tayyip Erdogan at Saturday's meeting for helping secure Brunson's release, despite a curt Twitter post from the Turkish leader earlier on Saturday repeating that Brunson's release was a court's decision to make, not his.	Tayyip Erdogan	President
WASHINGTON (Reuters) - President Donald Trump said on Saturday the release of U.S. pastor Andrew Brunson after two years in Turkish custody was a "tremendous step" toward improved relations with Turkey, but he denied cutting a deal with Ankara.	Andrew Brunson	U.S. pastor
“The people here gathered to hear reflections, to pray together, and to come together as a community of faith to say we stand for life, we want to be a voice for life,” Archbishop Gregory Aymond said.	Gregory Aymond	Archbishop
“We are a strong coalition here in Louisiana of women organizations and supporters and constituents that believe that access to birth control is a fundamental right and we will continue to fight for that,” Planned Parenthood Gulf Coast Representative Petrice Sams-Abiodun said.	Petrice Sams-Abiodun 	Planned Parenthood Gulf Coast Representative
The proposed community – Four Seasons at New Lenox – would be maintenance-free and include amenities such as a clubhouse, classes, a pool and walking trails, said Mark Mastrorocco, director of land acquisition for Hovnanian.	Mark Mastrorocco	director of land acquisition for Hovnanian
K. Hovnanian Homes will present a proposal for a 600-ranch home, resort-style community for age-55-and-older residents to the New Lenox Village Board’s Committee of the Whole on Monday night, Mayor Tim Baldermann said Friday.	Tim Baldermann	Mayor
A video shows Sen. David Perdue (R-Ga.) grabbing a cellphone from the hand of a student who asked a question about Georgia Secretary of State Brian Kemp’s voter registration policy.	David Perdue	Sen.
Last year, Gov. Kay Ivey issued a public health emergency to withstand the great number of widespread cases.	Kay Ivey	Gov.
“The more people that are vaccinated, the less likely it is to be as bad as last year," said Landon Dutton with American Family Care.	Landon Dutton	with American Family Care
Our public health folks are so compassionate we’re going to see that they’re taken care of," said Judy Smith, Administrator for the Northern District of the Alabama Health Department.	Judy Smith	Administrator for the Northern District of the Alabama Health Department
Lil Xan is a My Chemical Romance fan, not that we had any questions about the rapper’s emo-ness	Lil Xan	My Chemical Romance fan
ST. PAUL, Minn. (AP) — In their first year under new coach Rod Brind’Amour, the Carolina Hurricanes are using their youth and speed to wear out opponents.	Rod Brind’Amour	new coach
“In a realistic world, you’re happy you got a point out of that,” Minnesota coach Bruce Boudreau said.	Bruce Boudreau	Minnesota coach
It was a perfect way for families and individuals to put their faith into action," stated Rev. Dr. Robert Hartwell, Senior Pastor at Village Lutheran Church.	Rev. Dr. Robert Hartwell	Senior Pastor at Village Lutheran Church
The Chapel School is a place where we teach service as a way of life," stated Mr. Michael Schultz, Principal at The Chapel School. 	Mr. Michael Schultz	Principal at The Chapel School
How, after Nebraska came out of nowhere to make the NCAA Tournament in 2014, Michigan State coach Tom Izzo called him up to let him know just how difficult the next season would be.	Tom Izzo	Michigan State coach
Michigan State coach Tom Izzo (left) greets Nebraska coach Tim Miles last season in East Lansing, Mich.	Tom Izzo	Michigan State coach
Michigan State coach Tom Izzo (left) greets Nebraska coach Tim Miles last season in East Lansing, Mich.	Tim Miles	Nebraska coach
After highlight KO, Bellator 207 winner Mandel Nallo's goal is to be like Georges St-Pierre	Mandel Nallo	Bellator 207 winner
Brandon Kyle Woodruff (born February 10, 1993) is an American professional baseball pitcher for the Milwaukee Brewers of Major League Baseball (MLB).	Brandon Kyle Woodruff	American professional baseball pitcher
Justin Williams (born October 4, 1981) is a Canadian-American professional ice hockey right winger currently serving as the captain for the Carolina Hurricanesof the National Hockey League (NHL).	Justin Williams	Canadian-American professional ice hockey right winger
"He knows what he's doing. People just, they hear his accent and they just think, `Oh, this guys is just all rah-rah," senior tight end Foster Moreau said.	Foster Moreau	senior tight end
All together, InSight’s readings will help scientists figure out how planets are put together and how they evolve, says Suzanne Smrekar, the mission’s deputy principal investigator.	Suzanne Smrekar	mission’s deputy principal investigator
“There are certainly points that will make me smile if they go well,” Julie Wertz-Chen, an entry, descent, and landing team member, said the week before.	Julie Wertz-Chen	entry, descent, and landing team member